ABT About — около, приблизительно
AGN Again — опять, снова
AS Подождите. AS 5 — подождите 5 минут
AR Код обозначающий конец передачи
BK Break (Прерывание) обычно применяется при работе полудуплексом, но чаще можно услышать как отметку конца передачи какого либо текста или информации, либо просьбу «вклиниться» в QSO двух радиолюбителей.
BTU Back to you означает конец передачи своей информации и готовность слушать передачу корреспондента
BLG (БЛГ) от русского «благодарю» используется русскоязычными радиолюбителями, зарубежные радиолюбители иногда применяют при связи с русскоязычными радиолюбителями
CUAGN See you again — увидимся снова
CUL See you later — увидимся позже
CQ Общий вызов — «Всем, всем»
CONDX Conditions — условия чего-либо (чаще прохождения радиоволн)
CW Continious wave, Code work — незатухающие колебания, работа кодом (азбукой Морзе) Общепринятое обозначение радиотелеграфа.
DE Предлог, обозначающий «от», «я». Например UA0LDK DE RV6ASX, можно «расшифровать» как «Радиостанция с позывным UA0LDK, я радиостанция с позывным RV6ASX» Или «DE RV6ASX» — » я RV6ASX»
DX Дальняя, редкая станция, связь
DR Dear — дорогой
DSW ДСВ — сокращение от русского «До свидания»
ES Союз «и»
EX Бывший (в смысле вышедший из употребления) Например бывший позывной — EX CALL
FB Fine business — превосходно, прекрасно, замечательно
FER «За» Например, — «спасибо за связь» TNX FER QSO
FREQ Frequency — частота
GA Good Afternoon — добрый день
GB До свидания
GD Добрый день
GE Добрый вечер
GN Доброй ночи
GL Good Luck — Удачи
GLD Glad — рад
GUHOR Вас не слышу. Еще можно услышать «полный GUHOR на частоте (диапазоне)»
HAM Радиолюбитель имеющий передатчик. По поводу происхождения этого кода ходит много версий и легенд, какая из них верная точно никто не знает. Часто можно услышать или прочитать «аппаратура для Ham-radio» это означает «аппаратура для радиолюбителей увлекающихся радиоствязью»
HPE Hope — надеюсь
HR Here — здесь
HRD Heard — слышал, слышу
HI Выражение смеха
HW? How? — Как? В смысле как дела? как меня слышите? как приняли?
K от Key — ключ. Употребляется как знак окончания передачи и предложения перейти на передачу корреспонденту.
LID плохой, неопытный оператор
LTR Letter — письмо
MNI Many — много
MTR Meter — метр, измеритель чего-либо
NIL Ничего
NR Number — номер. Второе значение Near — около.
NW Now — сейчас
OK OK — из разговорного английского и русского языка — «Все хорошо» «Все правильно»
OM Old man — приятель, старина (в смысле «привет, старина!»)
OP Operator — оператор
PA Power Amplifier — усилитель мощности
PSE Please — Пожалуйста
PSK Pfase Shift Keyng — вид цифровой связи, по русски можно перевести как фазовое ключевание
PWR Power — Мощность
R Right — Правильно, принял правильно
RPT Repeat — Повторение. Report — Рапорт
RIG Передатчик, аппаратура приемо-передачи
RTTY Radioteletype — Радиотелетайп
SIGS, SIG Signals — Сигналы, сигнал
SN Soon — Скоро
SK Полный конец связи
SPB СПБ — Спасибо
SRI Sorry — Извините
SSB Single Side Band — Однополосная модуляция
STN Station — Станция
SWL Short Wave Listener — Коротковолновик — наблюдатель
TKS или TNX Thanks — Спасибо
TU Thank you — благодарю вас
TVI Television Interference — Помехи телевидению
U You — Вы
UR Your — Ваш
VY Very — Очень
YL Young Lady — Девушка
XYL EX Young Lady — Женщина, Жена
WX Погода
ZDR ЗДР — Здравствуйте
73 Наилучшие пожелания
88 Любовь и поцелуй (шутка, передается оператору женщине)
99 Не хочу с вами работать. Аналогично русской фразе «идите на…» одно из редких грубых выражений в радиолюбительском эфире.
= Знак раздела, передается телеграфом «-…-» Обозначает конец фразы, предложения